1111111111
1E01000CC1
1111000CC1
1001CC1001
1001CC1001
1CC0001001
1CC00010P1
1111111111