1111111111
1E00000CC1
1000000CC1
1001##1001
1001##1001
1CC0000001
1CC00000P1
1111111111