1111111111
1E00000001
1000000001
1001001001
1001001001
1000000001
10000000P1
1111111111