1111111111
1E00000CC1
1000000CC1
1001CC1001
1001CC1001
1CC0000001
1CC0000001
1111111111