1111111111
1E00000CC1
1000000CC111
1001CC100001
1001CC100001
1CC000000111
1CC00000P1
1111111111