111111
1000C1
10P001
100001
111101
1C10E1
111111